NO ./maps/textures/64x64/north.xpm
SO ./maps/textures/64x64/south.xpm
WE ./maps/textures/64x64/west.xpm
EA ./maps/textures/64x64/east.xpm

F 154, 117, 91
C 73, 138, 245

         11111111111111111111111
        1000000000110000000000001
        1011000001110000000000001
        1001000000000000000000001
111111111011000001110000000000001
10000000001100000111011111111111
11110111111111011100000010001
11110111111111011101010010001
11000000110101011100000010001
10000000000000001100000010001
1000000000000000110101000001
11000001110101011111011110N0111
11110111 1110101 10111010001
11111111 1111111 111111111111