NO ./maps/textures/big_size/north.xpm
SO ./maps/textures/big_size/south.xpm
WE ./maps/textures/big_size/west.xpm
EA ./maps/textures/big_size/east.xpm

F 154, 117, 91
C 73, 138, 245

111111111
1000000001
1001100001
1101N1011111
1011110001
1000000001
111111111