NO ./maps/textures/north.xpm
SO ./maps/textures/south.xpm
WE ./maps/textures/west.xpm
EA ./maps/textures/east.xpm

F 220,100,0
C 255,30,0

111111111
1000000001
1000000001
10000S0001
1000000001
1000000001
111111111