NO ./maps/textures/north.xpm
SO ./maps/textures/south.xpm
WE ./maps/textures/west.xpm
EA ./maps/textures/east.xpm

F 154, 117, 91
C 73, 138, 245

111111
100101
101001
1100N1
111111