NO ./maps/textures/north.xpm
SO ./maps/textures/south.xpm
WE ./maps/textures/west.xpm
EA ./maps/textures/east.xpm

F 154, 117, 91
C 73, 138, 245

11111
10001
10001
10001
10001
10001
10001
10001
10001
10001
10001
10001
10001
11001
10001
10001
10001
10001
10001
10011
10001
10001
10001
10001
10001
10001
10001
10001
10001
10001
10001
10001
10011
10001
10001
10001
10001
10001
10001
10001
10001
10001
10001
10001
10001
10001
10001
10001
10001
10001
10001
10001
10001
10001
10001
10001
10001
10001
10001
10001
10001
10001
10001
10001
10001
10001
10001
10001
10001
10001
10001
10001
10001
10001
10001
10001
10001
10001
10001
10001
10001
10001
10001
10001
10001
10001
10001
10001
10001
10001
10001
10001
10001
10001
10001
10001
10001
10001
10001
10001
10001
10001
10001
10001
10001
10001
10001
10001
10001
10001
10001
10001
10001
10001
10001
10001
10001
10001
10001
10001
10001
10001
10001
10001
10001
10001
10001
10001
10001
10001
10001
10001
10001
10001
10001
10001
10001
10001
10001
10001
10001
10001
10001
10001
10N01
11111